10 01 02 03 04 05 06 07 08 09 40 11 12 13 14 15 16 18 19 20 21 22 23 24 25 26 27 28 29 30 31 32 33 34 35 36 38 39 40 41 42 43 44 44 45 46 47 48 49 50
41 41 41 41 41 41 41 41 41 41 41 41 41 41 41 41 41 41 41 41 41 41 41 41 41 41 41 41 41 41 41 41 41 41 41 41 41 41 41 41 41 41 41 41 41 41 41 41 41 41
41 41 41 41 41 41 41 41 41 41 41 41 41 41 41 41 41 41 41 41 41 41 41 41 41 41 41 41 41 41 41 41 41 41 41 41 41 41 41 41 41 41 41 41 41 41 41 41 41 41 
41 41 41 41 41 41 41 41 41 41 41 41 41 41 41 41 41 41 41 41 41 41 41 41 41 41 41 41 41 41 41 41 41 41 41 41 41 41 41 41 41 41 41 41 41 41 41 41 41 41 
41 41 41 41 41 41 41 41 41 41 41 41 41 41 41 41 41 41 41 41 41 41 41 41 41 41 41 41 41 41 41 41 41 41 41 41 41 41 41 41 41 41 41 41 41 41 41 41 41 41 
41 41 41 41 41 41 41 41 41 41 41 41 41 41 41 41 41 41 41 41 41 41 41 41 41 41 41 41 41 41 41 41 41 41 41 41 41 41 41 41 41 41 41 41 41 41 41 41 41 41 
41 41 41 41 41 41 41 41 41 41 10 10 10 10 10 10 10 10 10 10 10 10 10 10 10 10 10 10 10 10 10 10 10 10 10 10 10 10 10 10 41 41 41 41 41 41 41 41 41 41 
41 41 41 41 41 41 41 41 41 41 10 10 10 10 10 10 10 10 10 10 10 10 10 10 10 10 10 10 10 10 10 10 10 10 10 10 10 10 10 10 41 41 41 41 41 41 41 41 41 41 
41 41 41 41 41 41 41 41 41 41 10 10 10 10 10 10 10 10 10 10 10 10 10 10 10 10 10 10 10 10 10 10 10 10 10 10 10 10 10 10 41 41 41 41 41 41 41 41 41 41 
41 41 41 41 41 41 41 41 41 41 10 10 40 40 40 40 40 40 40 10 41 10 40 40 40 40 40 40 40 10 41 10 40 40 40 40 40 40 40 10 41 41 41 41 41 41 41 41 41 41 
41 41 41 41 41 41 41 41 41 41 10 10 40 39 39 39 39 39 40 10 41 10 40 39 39 39 39 39 40 10 41 10 40 39 39 39 39 39 40 10 41 41 41 41 41 41 41 41 41 41 
41 41 41 41 41 41 41 41 41 41 10 10 40 39 39 39 39 39 40 10 41 10 40 39 39 39 39 39 40 10 41 10 40 39 39 39 39 39 40 10 41 41 41 41 41 41 41 41 41 41 
41 41 41 41 41 41 41 41 41 41 10 10 40 39 39 39 39 39 40 10 41 10 40 39 39 39 39 39 40 10 41 10 40 39 39 39 39 39 40 10 41 41 41 41 41 41 41 41 41 41 
41 41 41 41 41 41 41 41 41 41 10 10 40 39 39 39 39 39 40 10 41 10 40 39 39 39 39 39 40 10 41 10 40 39 39 39 39 39 40 10 41 41 41 41 41 41 41 41 41 41 
41 41 41 41 41 41 41 41 41 41 10 10 40 39 39 39 39 39 40 10 41 10 40 39 39 39 39 39 40 10 41 10 40 39 39 39 39 39 40 10 41 41 41 41 41 41 41 41 41 41 
41 41 41 41 41 41 41 41 41 41 10 10 40 40 39 39 39 40 40 10 41 10 40 40 39 39 39 40 40 10 41 10 40 40 39 39 39 40 40 10 41 41 41 41 41 41 41 41 41 41 
41 41 41 41 41 41 41 41 41 41 10 10 10 10 10 10 10 10 10 10 10 10 10 10 10 10 10 10 10 10 10 10 10 10 10 10 10 10 10 10 41 41 41 41 41 41 41 41 41 41 
41 41 41 41 41 41 41 41 41 41 10 10 35 33 33 33 33 33 33 33 33 33 33 33 33 33 33 33 33 33 33 33 33 33 33 33 33 36 41 41 41 41 41 41 41 41 41 41 41 41 
41 41 41 41 41 41 41 41 41 41 10 10 31 26 26 26 26 26 26 26 26 26 26 26 26 26 26 26 26 26 26 26 26 26 26 26 26 30 41 41 41 41 41 41 41 41 41 41 41 41 
41 41 41 41 41 41 41 41 41 41 10 10 37 28 28 28 28 28 28 28 28 28 28 28 28 28 28 28 28 28 28 28 28 28 28 28 28 38 41 41 41 41 41 41 41 41 41 41 41 41 
41 41 41 41 41 41 41 41 41 41 10 10 10 10 10 10 10 10 10 10 10 10 10 10 10 10 10 10 10 10 10 10 10 10 10 10 10 10 10 10 41 41 41 41 41 41 41 41 41 41 
41 41 41 41 41 41 41 41 41 41 10 10 40 40 40 40 40 40 40 10 41 10 40 40 40 40 40 40 40 10 41 10 40 40 40 40 40 40 40 10 41 41 41 41 41 41 41 41 41 41 
41 41 41 41 41 41 41 41 41 41 10 10 40 39 39 39 39 39 40 10 41 10 40 39 39 39 39 39 40 10 41 10 40 39 39 39 39 39 40 10 41 41 41 41 41 41 41 41 41 41 
41 41 41 41 41 41 41 41 41 41 10 10 40 39 39 39 39 39 40 10 41 10 40 39 39 39 39 39 40 10 41 10 40 39 39 39 39 39 40 10 41 41 41 41 41 41 41 41 41 41 
41 41 41 41 41 41 41 41 41 41 10 10 40 39 39 39 39 39 40 10 41 10 40 39 39 39 39 39 40 10 41 10 40 39 39 39 39 39 40 10 41 41 41 41 41 41 41 41 41 41 
41 41 41 41 41 41 41 41 41 41 10 10 40 39 39 39 39 39 40 10 41 10 40 39 39 39 39 39 40 10 41 10 40 39 39 39 39 39 40 10 41 41 41 41 41 41 41 41 41 41 
41 41 41 41 41 41 41 41 41 41 10 10 40 39 39 39 39 39 40 10 41 10 40 39 39 39 39 39 40 10 41 10 40 39 39 39 39 39 40 10 41 41 41 41 41 41 41 41 41 41 
41 41 41 41 41 41 41 41 41 41 10 10 40 40 39 39 39 40 40 10 41 10 40 40 39 39 39 40 40 10 41 10 40 40 39 39 39 40 40 10 41 41 41 41 41 41 41 41 41 41 
41 41 41 41 41 41 41 41 41 41 10 10 10 10 10 10 10 10 10 10 10 10 10 10 10 10 10 10 10 10 10 10 10 10 10 10 10 10 10 10 41 41 41 41 41 41 41 41 41 41 
41 41 41 41 41 41 41 41 41 41 10 10 35 33 33 33 33 33 33 33 33 33 33 33 33 33 33 33 33 33 33 33 33 33 33 33 33 36 10 10 41 41 41 41 41 41 41 41 41 41 
41 41 41 41 41 41 41 41 41 41 10 10 31 26 26 26 26 26 26 26 26 26 26 26 26 26 26 26 26 26 26 26 26 26 26 26 26 30 10 10 41 41 41 41 41 41 41 41 41 41 
41 41 41 41 41 41 41 41 41 41 10 10 37 28 28 28 28 28 28 28 28 28 28 28 28 28 28 28 28 28 28 28 28 28 28 28 28 38 10 10 41 41 41 41 41 41 41 41 41 41 
41 41 41 41 41 41 41 41 41 41 10 10 10 10 10 10 10 10 10 10 10 10 10 10 10 10 10 10 10 10 10 10 10 10 10 10 10 10 10 10 41 41 41 41 41 41 41 41 41 41 
41 41 41 41 41 41 41 41 41 41 10 10 10 10 10 10 10 10 10 10 10 10 10 10 10 10 10 10 10 10 10 10 10 10 10 10 10 10 10 10 41 41 41 41 41 41 41 41 41 41 
41 41 41 41 41 41 41 41 41 41 10 10 10 10 10 10 10 10 10 10 10 10 10 10 10 10 10 10 10 10 10 10 10 10 10 10 10 10 10 10 41 41 41 41 41 41 41 41 41 41 
41 41 41 41 41 41 41 41 41 41 10 10 10 10 10 10 10 10 10 10 10 10 10 10 10 10 10 10 10 10 10 10 10 10 10 10 10 10 10 10 41 41 41 41 41 41 41 41 41 41 
41 41 41 41 41 41 41 41 41 41 10 10 10 10 10 10 10 10 10 10 10 10 10 10 10 10 10 10 10 10 10 10 10 10 10 10 10 10 10 10 41 41 41 41 41 41 41 41 41 41 
41 41 41 41 41 41 41 41 41 41 10 10 10 10 10 10 10 10 10 10 10 10 10 10 10 10 10 10 10 10 10 10 10 10 10 10 10 10 10 10 41 41 41 41 41 41 41 41 41 41 
41 41 41 41 41 41 41 41 41 41 10 10 10 10 10 10 10 10 10 10 10 10 10 10 10 10 10 10 10 10 10 10 10 10 10 10 10 10 10 10 41 41 41 41 41 41 41 41 41 41 
41 41 41 41 41 41 41 41 41 41 10 10 10 10 10 10 10 10 10 10 10 10 10 10 10 10 10 10 10 10 10 10 10 10 10 10 10 10 10 10 41 41 41 41 41 41 41 41 41 41 
41 41 41 41 41 41 41 41 41 41 10 10 10 10 10 10 10 10 10 10 10 10 10 10 10 10 10 10 10 10 10 10 10 10 10 10 10 10 10 10 41 41 41 41 41 41 41 41 41 41 
41 41 41 41 41 41 41 41 41 41 10 10 10 10 10 10 10 10 10 10 10 10 10 10 10 10 10 10 10 10 10 10 10 10 10 10 10 10 10 10 41 41 41 41 41 41 41 41 41 41 
41 41 41 41 41 41 41 41 41 41 10 10 10 10 10 10 10 10 10 10 10 10 10 10 10 10 10 10 10 10 10 10 10 10 10 10 10 10 10 10 41 41 41 41 41 41 41 41 41 41 
41 41 41 41 41 41 41 41 41 41 10 10 10 10 10 10 10 10 10 10 10 10 10 10 10 10 10 10 10 10 10 10 10 10 10 10 10 10 10 10 41 41 41 41 41 41 41 41 41 41 
41 41 41 41 41 41 41 41 41 41 41 41 41 41 10 10 40 41 41 41 41 41 41 41 41 41 41 41 41 41 41 41 41 41 41 41 41 41 41 41 41 41 41 41 41 41 41 41 41 41
41 41 41 41 41 41 41 41 41 41 41 41 41 41 10 10 40 41 41 41 41 41 41 41 41 41 41 41 41 41 41 41 41 41 41 41 41 41 41 41 41 41 41 41 41 41 41 41 41 41 
41 41 41 41 41 41 41 41 41 41 41 41 41 41 10 10 40 41 41 41 41 41 41 41 41 41 41 41 41 41 41 41 41 41 41 41 41 41 41 41 41 41 41 41 41 41 41 41 41 41 
41 41 41 41 41 41 41 41 41 41 41 41 41 41 10 10 40 41 41 41 41 41 41 41 41 41 41 41 41 41 41 41 41 41 41 41 41 41 41 41 41 41 41 41 41 41 41 41 41 41 
41 41 41 41 41 41 41 41 41 41 41 41 41 41 10 10 40 41 41 41 41 41 41 41 41 41 41 41 41 41 41 41 41 41 41 41 41 41 41 41 41 41 41 41 41 41 41 41 41 41 
41 41 41 41 41 41 41 41 41 41 41 41 41 41 10 10 40 41 41 41 41 41 41 41 41 41 41 41 41 41 41 41 41 41 41 41 41 41 41 41 41 41 41 41 41 41 41 41 41 41 