41 41 41 41 41 41 41 41 41 41 41 41 41 41 41 41 41 41 41 41 41 41 41 41 41 41 41 41 41 41 41 41 41 41 41 41 41 41 41 41 41 41 41 41 41 41 41 41 41 41
41 41 41 41 41 41 41 41 41 41 41 41 41 41 41 41 41 41 41 41 41 41 41 41 41 41 41 41 41 41 41 41 41 41 41 41 41 41 41 41 41 41 41 41 41 41 41 41 41 41
41 41 41 41 41 41 41 41 41 41 41 41 41 41 41 41 41 41 41 41 41 41 41 41 41 41 41 41 41 41 41 41 41 41 41 41 41 41 41 41 41 41 41 41 41 41 41 41 41 41 
41 41 41 41 41 41 41 41 41 41 41 41 41 41 41 41 41 41 41 41 41 41 41 41 41 41 41 41 41 41 41 41 41 41 41 41 41 41 41 41 41 41 41 41 41 41 41 41 41 41 
41 41 41 41 41 41 41 41 41 41 41 41 41 41 41 41 41 41 41 41 41 41 41 41 41 41 41 41 41 41 41 41 41 41 41 41 41 41 41 41 41 41 41 41 41 41 41 41 41 41 
41 41 41 41 41 41 41 41 41 41 41 41 41 41 41 41 41 41 41 41 41 41 41 41 41 41 41 41 41 41 41 41 41 41 41 41 41 41 41 41 41 41 41 41 41 41 41 41 41 41 
41 41 41 41 41 41 41 41 41 41 10 10 10 10 10 10 10 10 10 10 10 10 10 10 10 10 10 10 10 10 10 10 10 10 10 10 10 10 10 10 41 41 41 41 41 41 41 41 41 41 
41 41 41 41 41 41 41 41 41 41 10 10 10 10 10 10 10 10 10 10 10 10 10 10 10 10 10 10 10 10 10 10 10 10 10 10 10 10 10 10 41 41 41 41 41 41 41 41 41 41 
41 41 41 41 41 41 41 41 41 41 10 10 10 10 10 10 10 10 10 10 10 10 10 10 10 10 10 10 10 10 10 10 10 10 10 10 10 10 10 10 41 41 41 41 41 41 41 41 41 41 
41 41 41 41 41 41 41 41 41 41 10 10 40 40 40 40 40 40 40 10 41 10 40 40 40 40 40 40 40 10 41 10 40 40 40 40 40 40 40 10 41 41 41 41 41 41 41 41 41 41 
41 41 41 41 41 41 41 41 41 41 10 10 40 39 39 39 39 39 40 10 41 10 40 39 39 39 39 39 40 10 41 10 40 39 39 39 39 39 40 10 41 41 41 41 41 41 41 41 41 41 
41 41 41 41 41 41 41 41 41 41 10 10 40 39 39 39 39 39 40 10 41 10 40 39 39 39 39 39 40 10 41 10 40 39 39 39 39 39 40 10 41 41 41 41 41 41 41 41 41 41 
41 41 41 41 41 41 41 41 41 41 10 10 40 39 39 39 39 39 40 10 41 10 40 39 39 39 39 39 40 10 41 10 40 39 39 39 39 39 40 10 41 41 41 41 41 41 41 41 41 41 
41 41 41 41 41 41 41 41 41 41 10 10 40 39 39 39 39 39 40 10 41 10 40 39 39 39 39 39 40 10 41 10 40 39 39 39 39 39 40 10 41 41 41 41 41 41 41 41 41 41 
41 41 41 41 41 41 41 41 41 41 10 10 40 39 39 39 39 39 40 10 41 10 40 39 39 39 39 39 40 10 41 10 40 39 39 39 39 39 40 10 41 41 41 41 41 41 41 41 41 41 
41 41 41 41 41 41 41 41 41 41 10 10 40 40 39 39 39 40 40 10 41 10 40 40 39 39 39 40 40 10 41 10 40 40 39 39 39 40 40 10 41 41 41 41 41 41 41 41 41 41 
41 41 41 41 41 41 41 41 41 41 10 10 10 10 10 10 10 10 10 10 10 10 10 10 10 10 10 10 10 10 10 10 10 10 10 10 10 10 10 10 41 41 41 41 41 41 41 41 41 41 
41 41 41 41 41 41 41 41 41 41 41 10 35 33 33 33 33 33 33 33 33 33 33 33 33 33 33 33 33 33 33 33 33 33 33 33 33 36 10 41 41 41 41 41 41 41 41 41 41 41 
41 41 41 41 41 41 41 41 41 41 41 10 31 26 26 26 26 26 26 26 26 26 26 26 26 26 26 26 26 26 26 26 26 26 26 26 26 30 10 41 41 41 41 41 41 41 41 41 41 41 
41 41 41 41 41 41 41 41 41 41 41 10 37 28 28 28 28 28 28 28 28 28 28 28 28 28 28 28 28 28 28 28 28 28 28 28 28 38 10 41 41 41 41 41 41 41 41 41 41 41 
41 41 41 41 41 41 41 41 41 41 10 10 10 10 10 10 10 10 10 10 10 10 10 10 10 10 10 10 10 10 10 10 10 10 10 10 10 10 10 10 41 41 41 41 41 41 41 41 41 41 
41 41 41 41 41 41 41 41 41 41 10 10 40 40 40 40 40 40 40 10 41 10 40 40 40 40 40 40 40 10 41 10 40 40 40 40 40 40 40 10 41 41 41 41 41 41 41 41 41 41 
41 41 41 41 41 41 41 41 41 41 10 10 40 39 39 39 39 39 40 10 41 10 40 39 39 39 39 39 40 10 41 10 40 39 39 39 39 39 40 10 41 41 41 41 41 41 41 41 41 41 
41 41 41 41 41 41 41 41 41 41 10 10 40 39 39 39 39 39 40 10 41 10 40 39 39 39 39 39 40 10 41 10 40 39 39 39 39 39 40 10 41 41 41 41 41 41 41 41 41 41 
41 41 41 41 41 41 41 41 41 41 10 10 40 39 39 39 39 39 40 10 41 10 40 39 39 39 39 39 40 10 41 10 40 39 39 39 39 39 40 10 41 41 41 41 41 41 41 41 41 41 
41 41 41 41 41 41 41 41 41 41 10 10 40 39 39 39 39 39 40 10 41 10 40 39 39 39 39 39 40 10 41 10 40 39 39 39 39 39 40 10 41 41 41 41 41 41 41 41 41 41 
41 41 41 41 41 41 41 41 41 41 10 10 40 39 39 39 39 39 40 10 41 10 40 39 39 39 39 39 40 10 41 10 40 39 39 39 39 39 40 10 41 41 41 41 41 41 41 41 41 41 
41 41 41 41 41 41 41 41 41 41 10 10 40 40 39 39 39 40 40 10 41 10 40 40 39 39 39 40 40 10 41 10 40 40 39 39 39 40 40 10 41 41 41 41 41 41 41 41 41 41 
41 41 41 41 41 41 41 41 41 41 10 10 10 10 10 10 10 10 10 10 10 10 10 10 10 10 10 10 10 10 10 10 10 10 10 10 10 10 10 10 41 41 41 41 41 41 41 41 41 41 
41 41 41 41 41 41 41 41 41 41 41 10 35 33 33 33 33 33 33 33 33 33 33 33 33 33 33 33 33 33 33 33 33 33 33 33 33 36 10 41 41 41 41 41 41 41 41 41 41 41 
41 41 41 41 41 41 41 41 41 41 41 10 31 26 26 26 26 26 26 26 26 26 26 26 26 26 26 26 26 26 26 26 26 26 26 26 26 30 10 41 41 41 41 41 41 41 41 41 41 41 
41 41 41 41 41 41 41 41 41 41 41 10 37 28 28 28 28 28 28 28 28 28 28 28 28 28 28 28 28 28 28 28 28 28 28 28 28 38 10 41 41 41 41 41 41 41 41 41 41 41 
41 41 41 41 41 41 41 41 41 41 10 10 10 10 10 10 10 10 10 10 10 10 10 10 10 10 10 10 10 10 10 10 10 10 10 10 10 10 10 10 41 41 41 41 41 41 41 41 41 41 
41 41 41 41 41 41 41 41 41 41 10 10 10 10 10 10 10 10 10 10 10 10 10 10 10 10 10 10 10 10 10 41 40 40 40 40 40 40 40 10 41 41 41 41 41 41 41 41 41 41 
41 41 41 41 41 41 41 41 41 41 10 10 10 10 10 10 10 10 10 10 10 10 10 10 10 10 10 10 10 10 10 41 40 39 39 39 39 39 40 10 41 41 41 41 41 41 41 41 41 41 
41 41 41 41 41 41 41 41 41 41 10 10 10 10 10 10 10 10 10 10 10 10 10 10 10 10 10 10 10 10 10 41 40 39 39 39 39 39 40 10 41 41 41 41 41 41 41 41 41 41 
41 41 41 41 41 41 41 41 41 41 10 10 10 10 10 10 10 10 10 10 10 10 10 10 10 10 10 10 10 10 10 10 39 39 39 39 39 39 40 10 41 41 41 41 41 41 41 41 41 41 
41 41 41 41 41 41 41 41 41 41 10 10 10 10 10 10 10 10 10 10 10 10 10 10 10 10 10 10 10 10 10 10 39 39 39 39 39 39 40 10 41 41 41 41 41 41 41 41 41 41 
41 41 41 41 41 41 41 41 41 41 10 10 10 10 10 10 10 10 10 10 10 10 10 10 10 10 10 10 10 10 10 41 40 39 39 39 39 39 40 10 41 41 41 41 41 41 41 41 41 41 
41 41 41 41 41 41 41 41 41 41 10 10 10 10 10 10 10 10 10 10 10 10 10 10 10 10 10 10 10 10 10 41 40 39 39 39 39 39 40 10 41 41 41 41 41 41 41 41 41 41 
41 41 41 41 41 41 41 41 41 41 10 10 10 10 10 10 10 10 10 10 10 10 10 10 10 10 10 10 10 10 10 41 40 40 40 40 40 40 40 10 41 41 41 41 41 41 41 41 41 41 
41 41 41 41 41 41 41 41 41 41 10 10 10 10 10 10 10 10 10 10 10 10 10 10 10 10 10 10 10 10 10 10 10 10 10 10 10 10 10 10 41 41 41 41 41 41 41 41 41 41 
41 41 41 41 41 41 41 41 41 41 10 10 10 10 10 10 10 10 10 10 10 10 10 10 10 10 10 10 10 10 10 10 10 10 10 10 10 10 10 10 41 41 41 41 41 41 41 41 41 41 
41 41 41 41 41 41 41 41 41 41 10 10 10 10 10 10 10 10 10 10 10 10 10 10 10 10 10 10 10 10 10 10 10 10 10 10 10 10 10 10 41 41 41 41 41 41 41 41 41 41 
41 41 41 41 41 41 41 41 41 41 41 41 41 41 40 10 40 41 41 41 41 41 41 41 41 41 41 41 41 41 41 41 41 41 41 41 41 41 41 41 41 41 41 41 41 41 41 41 41 41
41 41 41 41 41 41 41 41 41 41 41 41 41 41 40 10 40 41 41 41 41 41 41 41 41 41 41 41 41 41 41 41 41 41 41 41 41 41 41 41 41 41 41 41 41 41 41 41 41 41 
41 41 41 41 41 41 41 41 41 41 41 41 41 41 40 10 40 41 41 41 41 41 41 41 41 41 41 41 41 41 41 41 41 41 41 41 41 41 41 41 41 41 41 41 41 41 41 41 41 41 
41 41 41 41 41 41 41 41 41 41 41 41 41 41 40 10 40 41 41 41 41 41 41 41 41 41 41 41 41 41 41 41 41 41 41 41 41 41 41 41 41 41 41 41 41 41 41 41 41 41 
41 41 41 41 41 41 41 41 41 41 41 41 41 41 40 10 40 41 41 41 41 41 41 41 41 41 41 41 41 41 41 41 41 41 41 41 41 41 41 41 41 41 41 41 41 41 41 41 41 41 
41 41 41 41 41 41 41 41 41 41 41 41 41 41 40 10 40 41 41 41 41 41 41 41 41 41 41 41 41 41 41 41 41 41 41 41 41 41 41 41 41 41 41 41 41 41 41 41 41 41 